NO ./img/blackandwhite_theme/ronds.xpm
SO ./img/blackandwhite_theme/des.xpm
WE ./img/blackandwhite_theme/losanges.xpm
EA ./img/blackandwhite_theme/briques.xpm

F 220,100,0
C 17,160,242

111111111111111111111111111
100000000000000000000000001
100000001110000001111100001
100000110110000010001100001
100001100110000000110000011
100011111111100000110000001
100000000110000011000000001
100000000111101111111000001
10000000000W000000000000011
111111111111111111111111111