NO ./img/lescopines/gagao_111.xpm
SO ./img/lescopines/lee.xpm
WE ./img/lescopines/neige_1.xpm
EA ./img/lescopines/nico_1.xpm

F 225,100,0
C 17,160,242

111111111111111111111111111
100001100110000000011000001
100011111111100000110000001111111
100000000110000011000000000000W01
100000000110000111111000001111111
100000000000000000000000001
111111111111111111111111111