SO ./img/blackandwhite_theme/des.xpm

WE ./img/blackandwhite_theme/losanges.xpm

C 17,160,242

F 220,100,250


NO ./img/blackandwhite_theme/ronds.xpm
EA ./img/blackandwhite_theme/briques.xpm



111111111111111111111111111
10000000000000000000000001
100000001110000001111100001
1000001101100H0010001100001
1000011001100H0000011000001
1000111111111H0000110000001
100000000110000011000000001
1000000001100H00111111000001
100H000000000N0000000000001
111111111111111111111111111
