SO ./img/blackandwhite_theme/des.xpm

WE ./img/blackandwhite_theme/losanges.xpm


C 17,160,242
F 220,100,250


NO ./img/blackandwhite_theme/ronds.xpm
EA ./img/blackandwhite_theme/briques.xpm


 
111111111111111111111111111
10000000000000000000000001
100000001110000001111100001
10000011011000010001100001
10000110011000000011000001
10001111111110000110000001
100000000110000011000000001
100000000110000111111000001
100000000000N0000000000001
111111111111111111111111111
