NO ./img/blackandwhite_theme/ronds.xpm
SO ./img/blackandwhite_theme/des.xpm
WE ./img/blackandwhite_theme/losanges.xpm
EA ./img/blackandwhite_theme/briques.xpm

F 225,100,0
C 17,160,242

111111111111111111111111111
100000000000000000000000001
100000011100000011111000001
100000110110000010S01100001
100001100110000000011000001
100011111111100000110000001
100000000110000011000000001
100000000110000111111000001
100000000000000000000000001
111111111111111111111111111