NO ./img/path_to_the_north_texture
SO ./img/path_to_the_south_texture
WE ./img/path_to_the_west_texture
EA ./img/path_to_the_east_texture

F 220,100,0
C 225,30,0

11111
11001

1111111111111111111111111 1111
1000000000110000000000001 1111
1011000001110000000000001        
100100000000000000000000111111111
111111111011000001110000000000001
100000000011000001110111111111111
111101111111110N11000000100001111    
111101111111110111010100100011111    
110000001101010111000000100011111
100000000000000011000000100011111
1000000000 00000011010100100011111
110000011101010111110111100011111
11111111 1111101 1011110100011111
11111111 1111111 111111111111

1





