NO ./img/blackandwhite_theme/ronds.xpm
SO ./img/blackandwhite_theme/des.xpm


C 200,30,38
EA              ./img/blackandwhite_theme/briques.xpm

                F 255,100,0
WE ./img/blackandwhite_theme/losanges.xpm


        1111111111111111111111111
        100000100011000000000011 1
        10110000011100000S000001 1
        10010000000000000000000111
111111111011000001110000000000001
10000000001100000111D111111111111
11110111111111011100000010001
11110111111111011101010010001    1
11000000110101011100000010001   101
10000000000000001100000000001    1       
10000000000000001101010010001
1100000111010101111101111000111
11110111 1110101 101111010001
11111111 1111111 111111111111
1