NO ./img/lescopines/gagao_111.xpm
SO ./img/lescopines/lee.xpm
WE ./img/lescopines/neige_1.xpm

F                        225,100,0
C 17,160,242

EA ./img/lescopines/nico_1.xpm

11111111111111111
10000010000000001
10000010000001001
10000000000000001
11111111011111111
10101000000000101
10000000100000101
11111111111111111