NO ./img/lescopines/gagao_111.xpm
SO ./img/lescopines/lee.xpm
WE ./img/lescopines/neigellllllllllllllllllllllllllll_1.xpm

F                        225,100,0
C 17,160,242

EA ./img/lescopines/nico_1.xpm

11111111111111111
10000001000000001
10000000000000001
10001010001000001
10000000000000001
10000000N00000001
10000000000000001
11111111111111111